##################B#
#   ####### ###### #
# # #              #
# ### ###### #######
#     ##############
#####        ####  #
###### #####      ##
##     ##### #######
#########    #######
####      #####   ##
#### ########## # ##
##   #####      ####
## ####### #########
##            ######
############# ##  ##
######        ### ##
###    #### ###   ##
### #######     ####
###    ######## ####
###############A####
